###############
#      @      #
#rr           #
# #         ###
# #   o o  h#a#
# #h   b    #*#
#a#    b   h#a#
#*#h   b    # #
#a#    b   h# #
###h   b    # #
#             #
#           b #
#######o#######
#1     x     *#
###############
